7 7 7 7 7 7 7 7 7 7 7 7 7 7 7 7 7 7 7 7
7 7 4 0 0 0 0 5 7 7 4 0 0 0 0 0 0 5 7 7
7 4 0 0 0 0 0 0 5 4 0 0 0 0 0 0 0 0 5 6
7 0 0 0 0 0 0 0 0 0 0 0 0 0 0 0 0 0 0 0
7 0 0 0 0 0 0 0 0 0 0 0 0 0 0 0 0 9 3 3
7 0 0 0 0 0 0 0 0 0 0 0 0 0 0 0 0 5 7 7
7 0 0 0 0 0 0 0 9 8 0 0 9 3 3 8 0 0 5 7
7 0 0 0 0 0 0 0 5 4 0 0 5 6 6 4 0 0 0 7
7 0 0 0 0 9 8 0 0 0 0 0 0 0 0 0 0 0 0 7
7 0 0 0 0 5 4 0 0 0 0 0 0 0 0 0 0 0 0 7
7 0 9 8 0 0 0 0 0 0 0 0 0 0 0 0 0 0 0 7
7 3 3 3 3 3 3 3 3 3 3 3 3 3 3 3 3 3 3 7
64 640
1 5