0 0 0 0 0 0 0 0 0 0 0 0 2 2 2 0 0 0 0 0
0 0 0 0 0 0 0 0 0 0 0 0 2 2 2 0 0 0 0 0
0 0 0 0 0 15 1 14 0 0 0 0 2 2 0 0 0 0 0 0
0 0 0 11 13 2 2 2 13 12 0 0 2 2 0 0 0 0 15 1
0 0 0 0 0 2 2 2 0 0 0 0 2 0 0 0 0 0 2 2
0 11 12 0 0 2 2 2 0 0 11 13 2 0 0 0 0 11 2 2
0 0 0 0 0 2 2 2 0 0 0 0 0 0 0 0 0 0 2 2
0 0 0 11 13 2 2 2 0 0 0 0 0 0 0 11 12 0 2 2
0 0 0 0 0 2 2 2 0 0 0 0 0 0 0 0 0 0 2 2
1 14 0 0 0 2 2 2 13 12 0 0 11 13 12 0 0 0 2 2
2 2 0 0 0 2 2 2 0 0 0 0 0 0 0 0 0 0 2 2
2 2 0 0 0 2 2 2 0 0 0 0 0 0 0 0 0 0 2 2
0 512
12 14