7 7 7 7 7 7 7 7 7 7 7 7 7 7 7 7 7 7 7 7
7 7 4 0 0 0 0 5 7 7 4 0 0 0 0 5 7 7 4 0
7 4 0 0 0 0 0 0 5 4 0 0 0 0 0 0 5 4 0 0
7 0 0 0 0 0 0 0 0 0 0 0 0 0 0 0 0 0 0 0
7 0 0 0 0 0 0 0 0 0 0 0 0 0 0 0 0 8 3 3
7 0 0 0 0 0 0 0 0 0 0 0 0 0 0 0 0 0 5 7
7 0 0 0 0 0 0 0 8 9 0 0 8 6 6 9 0 0 0 7
7 0 0 0 0 0 0 0 0 0 0 0 0 0 0 0 0 0 0 7
7 0 0 0 0 8 9 0 0 0 0 0 0 0 0 0 0 0 0 7
7 0 8 9 0 0 0 0 0 0 0 0 0 0 0 0 0 0 0 7
7 0 0 0 0 0 0 0 0 0 0 0 0 0 0 0 0 0 0 7
7 3 3 3 3 3 3 3 3 3 3 3 3 3 3 3 3 3 3 7
64 640
1 5