7 7 7 7 7 7 7 7 7 7 7 7 7 7 7 7 0 0 0 0
0 0 0 0 0 0 0 0 0 0 0 0 0 5 7 7 7 0 0 0
0 0 0 0 0 0 0 0 0 0 0 0 0 0 5 7 7 7 0 0
0 0 0 0 0 0 0 0 0 0 0 0 0 0 0 0 5 7 7 0
3 3 9 0 0 0 0 0 0 0 0 0 0 0 0 0 0 7 7 0
7 7 0 0 0 0 0 0 0 0 0 0 0 0 0 0 0 5 4 0
7 7 0 8 9 0 0 0 0 0 0 0 0 0 0 0 0 0 0 0
7 4 0 0 0 0 0 0 0 0 0 0 0 0 0 0 0 0 0 0
7 0 0 0 0 8 9 0 0 0 0 8 9 0 0 8 3 3 1 1
7 0 0 0 0 0 0 0 0 0 0 0 0 0 0 0 5 7 2 2
7 0 0 0 0 0 0 0 0 8 9 0 0 0 0 0 0 7 2 2
7 0 0 0 0 0 0 0 0 0 0 0 0 0 0 0 0 7 2 2
0 192
6 8