0 0 0 0 0 0 0 0 0 0 0 0 0 0 0 0 0 0 0 0
0 0 0 11 12 0 0 0 0 0 0 0 0 0 0 0 0 0 0 0
0 0 0 0 0 0 0 11 12 0 0 0 0 0 0 0 0 0 0 0
0 11 12 0 0 0 0 0 0 0 0 11 12 0 0 0 0 0 1 1
0 0 0 0 0 0 0 0 0 0 0 0 0 0 0 0 1 1 2 2
0 0 0 11 12 0 0 0 0 0 0 0 0 0 0 11 2 2 2 2
0 0 0 0 0 0 0 0 0 0 0 0 0 0 0 0 2 2 2 2
0 0 0 0 0 11 12 0 0 0 0 0 0 0 0 0 2 2 2 2
1 1 0 0 0 0 0 0 0 0 0 0 0 0 0 0 2 2 2 2
2 2 1 1 1 1 1 1 1 1 1 1 1 1 1 1 2 2 2 2
2 2 2 2 2 2 2 2 2 2 2 2 2 2 2 2 2 2 2 2
2 2 2 2 2 2 2 2 2 2 2 2 2 2 2 2 2 2 2 2
0 448
0 0